31111111111111111119
20000000000000000008
20000000000000000008
20000000000000000008
20000000000000000008
20000000000000000008
20000000000000000008
20000000000000000008
20000000000000000008
20000000000000000008
20000000000000000008
20000000000000000008
20000000000000000008
20000000000000000008
6444444444444444444C
